??????????????????????????????????????????????????
??????????????????????????????????????????????????
??????????????????????????????????????????????????
??????????????????????????????????????????????????
?????###########?###??????????????????????????????
????#           #   #?????????????????????????????
????# ### ##### # # ##????????????????????????????
????? #   #???#   #   #???????????????????????????
????? # #??????###?## #???????????????????????????
??????# #?????????#   #???????????????????????????
??????# #?????????# #??????###????????????????????
??????# #?????????# #?????#    ???????????????????
??????# #?????????# ####??# ##????????????????????
??????# #?????????#     #?#   ????????????????????
??????# #??????????#### ???## #???????????????????
????#   #?????????#     ??#   #???????????????????
????# ##?????????## ####### ##????????????????????
????#   #???????#   #     #   #???????????????????
??????# #???????# ### ### ### #???????????????????
??????# #???????#     #       #???????????????????
?????## #????????#### #######?????????????????????
????#   #?????????????#   #???????????????????????
????# ##?#####?#####?## # #???????????????????????
????#   #     #     #   # #???????????????????????
????# # # ### # ### # ### #???????????????????????
????# #   # # # # # #   # #???????????????????????
????# ##### # # # # ### ##????????????????????????
????#       # #   #     #?????????????????????????
?????###?## # ### ##############??????????????????
????#   #   # #   #             #?????????????????
????# ### ### # ######### ##### #?????????????????
????# #   #   #           #     #?????????????????
????# # ### ############### ######????????????????
????#     #     #     #   #       #???????????????
????# ####### # # ### ### ####### #???????????????
????#   #     #   #       #     # #???????????????
????# ### ######### ####### # ### #???????????????
??????#   #     #   #       # #   #???????????????
??????# ### ### ##### ####### # ##????????????????
??????#   #   # #     # #     # #?????????????????
???????## ### # # ##### # ### # ##????????????????
????????#     # # #   # # #   # #?????????????????
?????????###### # # # # # ##### #?????????????????
??????????????#     #   #       #?????????????????
???????????????#####?###?#######??????????????????
??????????????????????????????????????????????????
??????????????????????????????????????????????????
??????????????????????????????????????????????????
??????????????????????????????????????????????????
??????????????????????????????????????????????????
??????????????????????????????????????????????????
??????????????????????????????????????????????????